#############
#           #
#           #
#     #     #
#           #
#     #     #
#           #
#############
