#############
#           #
#     #     #
#           #
#     #     #
#           #
#        $  #
#           #
#   $       #
#         $ #
#           #
#           #
#############
