###################
#                 #
#     #     #     #
#                 #
#     #           #
#                 #
# o    #    #     #
#      #    #     #
#   o  #    #     # 
#      #$$$$#     #
#      ######     #
#    o o  C       #
###################
