###################
#          O       #
#     #     #    #
#                #
#     #    C      #
#                 #
# o    #    # O    #
#      #    #     #
#   o  #    #     # 
#      #$$$$#     #
#      ######     #
#    o o          #
###################
