#############
#           #
#     #     #
#           #
#     #     #
#           #
# o  C      #
#           #
#   o       #
#         $ #
#           #
#           #
#############
